257 312 376 302 115 
277 225 344 371 459 189 
79 293 513 680 158 171 
93 208 353 501 190 
107 315 263 341 542 262 
239 442 526 624 123 170 191 
54 326 449 318 536 314 
85 184 418 461 480 509 
85 361 241 494 334 352 253 145 
281 307 442 340 575 344 249 31 
54 129 256 383 467 443 474 233 
243 377 508 663 518 150 101 133 251 
145 363 319 626 753 645 647 223 
255 537 530 578 149 253 484 454 275 174 171 
153 235 338 678 840 849 
28 55 66 333 567 488 578 575 318 377 122 89 120 
13 169 353 581 886 502 584 645 240 246 
75 234 326 666 508 761 796 293 227 
251 272 586 149 332 527 476 544 414 140 
139 358 676 1074 960 747 361 
158 316 241 586 943 473 451 392 235 91 94 
73 246 465 954 988 613 671 227 
116 353 603 773 1122 1149 926 173 
224 322 800 476 631 964 623 424 343 52 
289 415 517 465 1012 923 859 479 136 
54 254 520 561 830 1144 554 167 
105 243 506 609 981 1388 1237 272 550 
263 415 862 838 587 295 441 499 317 172 175 
176 325 641 1026 1330 873 322 436 105 101 
105 320 594 1136 1158 838 977 427 289 279 
98 301 128 337 535 963 1072 1606 1182 261 
101 169 503 1012 904 539 806 1011 878 401 
24 42 78 71 125 133 123 65 17 
7 27 55 70 71 118 93 130 65 44 18 
62 224 413 702 1025 1630 1221 611 153 
12 27 57 82 100 125 119 68 26 15 
24 38 79 70 89 102 96 76 48 18 18 
285 560 794 1322 999 755 547 363 547 446 423 452 366 114 
279 314 95 243 508 960 1240 1048 814 623 298 344 521 169 
225 387 771 1255 1607 1312 1418 493 319 129 
20 32 73 112 154 172 91 27 15 15 27 
22 26 57 89 97 94 105 49 47 49 53 33 34 
5 299 25 77 241 468 988 1347 1015 827 867 492 597 240 298 280 
12 236 501 927 1345 1929 1967 1295 652 309 151 
136 257 576 923 1285 1386 919 1141 1247 453 227 
5 9 21 30 53 82 136 162 119 63 56 56 
16 20 40 67 113 135 123 86 45 24 46 19 12 10 
3 6 23 42 75 115 158 193 150 62 46 
18 32 63 95 118 144 113 97 74 23 14 
282 342 486 406 735 994 1608 1926 986 240 232 
14 29 52 90 92 110 103 13 
26 37 23 46 72 67 86 103 123 57 17 
136 207 557 915 811 882 717 696 
251 309 720 789 463 774 918 413 374 376 
81 207 431 842 809 836 1066 774 92 
1 4 15 29 60 118 116 49 
22 33 73 86 96 118 56 33 
6 23 37 79 83 92 66 23 
263 319 506 163 274 485 486 51 
27 53 93 100 52 86 81 66 43 54 11 
9 20 42 74 102 79 95 73 25 49 25 
256 375 673 568 412 397 444 423 
16 30 62 84 127 72 44 
17 36 65 73 67 74 29 34 
11 23 46 87 88 68 86 100 113 37 37 22 
144 308 677 850 1485 968 924 858 735 313 66 
116 243 574 960 700 921 498 432 386 222 
288 456 364 632 710 1017 1150 946 537 20 
106 319 645 854 1206 1553 1135 1129 637 586 
283 531 641 684 543 889 842 471 707 558 761 
153 384 607 1001 1712 1108 858 657 31 
138 260 491 997 1110 1166 1586 849 280 
249 318 626 556 683 809 675 556 224 
20 43 76 70 107 84 76 38 
5 22 48 62 111 148 143 138 23 
149 386 732 1184 1390 914 751 1021 430 
286 304 515 448 775 1167 825 874 411 391 79 
4 27 39 58 75 90 173 79 68 23 
26 43 83 76 87 81 93 99 15 
191 326 595 659 589 751 472 488 397 134 
118 236 521 1085 1232 1906 801 504 286 79 
29 27 50 85 119 138 111 76 81 56 45 7 
182 456 452 815 860 1403 1783 1351 744 551 249 
95 375 325 477 925 895 324 461 740 607 354 169 
20 37 68 117 90 120 91 18 37 
163 259 530 848 1226 1467 1210 1050 471 100 115 104 
167 374 752 1279 2372 2543 1004 133 10 
12 32 49 82 66 46 65 78 70 57 18 37 
42 98 360 641 1064 877 1293 1160 630 248 
6 19 44 81 112 152 111 90 49 14 
143 325 657 1068 1370 1159 1041 1042 775 449 186 188 
23 45 73 79 137 107 119 65 50 30 
96 202 446 917 1053 1697 2211 678 618 433 
118 334 634 1213 1900 1592 1551 709 372 
74 124 251 591 1145 1585 1801 1215 1002 903 393 
0 23 41 72 121 165 212 193 107 47 14 
29 8 26 42 86 67 123 136 105 67 13 
54 220 484 890 1255 1309 1206 553 130 266 
68 336 545 446 795 1101 1549 2040 2162 759 94 
196 402 778 1023 1549 2184 1353 977 754 608 80 
